BABABABABABA
AAAAAAAAAAAA
BAAAAAAAAAAA
AAAAAAAAAAAA
BAAAAAAAAAAA
AAAAAAAAAAAA
BAAAAAAAAAAA
AAAAAAAAAAAA
BAAAAAAAAAAA
AAAAAAAAAAAA
BAAAAAAAAAAA
AAAAAAAAAAAB