AAAAAAAAAAAAAAAA
ABBBBBAAAAAAAAAA
ABAAAAAAAAAAAAAA
ABAAAAAAAAAAAAAA
ABBBBBAAAAAAAAAA
AAAAAAAAAAAAAAAA
AAAAAAAABBBBBBAA
AAAAAAAABAAAABAA
AAAAAAAABAAAABAA
AAAAAAAABBBBBBAA
ABBBBBAAAAAAAAAA
ABAAABAAAAAAAAAA
ABBBBBAAAAAAAAAA
ABAAAAAAAAAAAAAA
ABAAAAAAAAAAAAAA
AAAAAAAAAAAAAAAA